25 25
100 100
4 10 10 10 10 10 10 10 10 10 10 10 10 10 10 10 10 10 10 10 10 10 10 10 5
8 1  1  1  1  1  1  1  1  1  1  1  1  1  1  1  1  1  1  1  1  1  1  1  9
8 1  1  1  1  3  3  3  3  1  1  1  1  1  1  1  1  1  1  1  3  3  3  3  9
8 1  1  3  1  1  1  1  3  1  1  1  1  1  1  1  1  1  1  1  1  3  3  3  9
8 1  1  3  3  3  3  3  3  1  1  1  1  1  1  1  1  1  1  1  1  1  1  3  9
8 1  1  1  3  3  1  1  1  1  1  1  1  1  3  1  1  1  1  1  1  3  3  3  9
8 1  1  1  1  3  3  1  1  1  1  1  1  1  1  1  1  1  1  1  3  3  3  3  9
8 1  1  1  1  1  3  3  1  1  1  1  1  1  1  1  1  1  1  1  1  1  1  1  9
8 1  1  1  1  1  1  3  3  1  1  1  1  1  1  1  1  1  1  1  1  1  1  1  9
8 1  1  1  1  1  1  3  3  1  1  1  1  1  1  1  12 1  1  1  1  1  1  1  9
8 1  1  1  1  1  1  1  1  1  1  1  1  1  1  12 1  1  1  1  1  1  1  1  9
8 1  1  1  1  1  1  1  1  1  1  3  1  1  1  1  1  1  1  1  1  1  1  1  9
8 1  1  1  1  1  1  1  1  1  1  1  1  1  12 1  1  1  1  1  1  1  1  1  9
8 1  1  1  1  1  1  1  1  1  1  1  1  1  1  1  1  1  12 1  1  1  1  1  9
8 1  1  1  1  1  1  1  12 12 12 12 12 12 12 12 1  1  12 1  12 12 12 12 9
8 1  12 12 12 1  12 1  12 12 1  1  1  1  1  12 1  1  1  1  1  1  12 12 9
8 1  1  1  1  1  12 1  12 1  1  12 3  1  1  1  1  1  12 12 1  1  1  1  9
8 1  12 12 1  1  1  12 1  1  1  1  12 12 1  12 12 12 1  1  1  1  1  1  9
8 1  1  1  1  1  1  1  1  12 1  1  1  1  1  1  1  1  1  1  1  1  1  1  9
8 1  1  1  1  1  1  1  1  1  1  1  1  1  1  1  1  1  1  1  1  1  1  1  9
8 1  1  1  1  1  1  1  1  1  1  1  1  1  1  1  1  1  1  12 1  1  1  1  9
8 1  1  1  1  1  1  1  1  1  1  1  1  1  1  1  1  1  1  1  1  1  1  1  9
8 1  1  1  1  1  1  1  1  1  1  1  1  1  1  1  1  1  1  1  1  1  1  1  9
8 1  1  1  1  1  1  12 1  1  1  1  1  1  1  1  1  1  1  1  1  1  1  1  9
7 11 11 11 11 11 11 11 11 11 11 11 11 11 11 11 11 11 11 11 11 11 11 11 6